Challenge,Predicate,NumSubmissions,NumCorrect,NumIncorrect,NumEdges
jyS8Bmceejj9pLbTW,Inv1,30,7,23,48
jyS8Bmceejj9pLbTW,Inv2,55,7,48,75
jyS8Bmceejj9pLbTW,Inv3,45,18,27,56
jyS8Bmceejj9pLbTW,Inv4,109,20,89,136
QxGnrFQnXPGh2Lh8C,inv1,234,22,212,352
QxGnrFQnXPGh2Lh8C,inv2,122,19,103,216
QxGnrFQnXPGh2Lh8C,inv3,471,31,440,829
QxGnrFQnXPGh2Lh8C,inv4,207,38,169,312
QxGnrFQnXPGh2Lh8C,inv5,407,28,379,544
QxGnrFQnXPGh2Lh8C,inv6,136,22,114,236
QxGnrFQnXPGh2Lh8C,inv7,135,13,122,175
QxGnrFQnXPGh2Lh8C,inv8,180,21,159,322
QxGnrFQnXPGh2Lh8C,inv9,371,25,346,503
QxGnrFQnXPGh2Lh8C,inv10,170,30,140,251
bNCCf9FMRZoxqobfX,inv1,58,20,38,101
bNCCf9FMRZoxqobfX,inv2,224,43,181,334
bNCCf9FMRZoxqobfX,inv3,46,13,33,71
bNCCf9FMRZoxqobfX,inv4,135,36,99,199
bNCCf9FMRZoxqobfX,inv5,141,58,83,192
bNCCf9FMRZoxqobfX,inv6,125,10,115,217
bNCCf9FMRZoxqobfX,inv7,88,33,55,150
bNCCf9FMRZoxqobfX,inv8,95,44,51,126
bNCCf9FMRZoxqobfX,inv9,458,61,397,581
bNCCf9FMRZoxqobfX,inv10,168,32,136,206
PQAJE67kz8w5NWJuM,inv1,35,18,17,59
PQAJE67kz8w5NWJuM,inv2,31,8,23,58
PQAJE67kz8w5NWJuM,inv3,31,7,24,50
PQAJE67kz8w5NWJuM,inv4,44,14,30,76
PQAJE67kz8w5NWJuM,inv5,84,11,73,166
PQAJE67kz8w5NWJuM,inv6,88,13,75,167
PQAJE67kz8w5NWJuM,inv7,124,24,100,224
PQAJE67kz8w5NWJuM,inv8,19,13,6,29
PQAJE67kz8w5NWJuM,inv9,98,20,78,129
PQAJE67kz8w5NWJuM,inv10,91,16,75,150
FwCGymHmbqcziisH5,prop1,45,7,38,58
FwCGymHmbqcziisH5,prop2,35,4,31,60
FwCGymHmbqcziisH5,prop3,120,9,111,163
FwCGymHmbqcziisH5,prop4,49,8,41,68
FwCGymHmbqcziisH5,prop5,87,1,86,100
FwCGymHmbqcziisH5,prop6,60,3,57,72
FwCGymHmbqcziisH5,prop7,30,4,26,35
FwCGymHmbqcziisH5,prop8,30,3,27,29
FwCGymHmbqcziisH5,prop9,68,1,67,78
FwCGymHmbqcziisH5,prop10,9,6,3,10
FwCGymHmbqcziisH5,prop11,14,3,11,21
FwCGymHmbqcziisH5,prop12,2,1,1,1
FwCGymHmbqcziisH5,prop13,11,3,8,12
FwCGymHmbqcziisH5,prop14,22,1,21,25
FwCGymHmbqcziisH5,prop15,30,4,26,33
FwCGymHmbqcziisH5,prop16,7,2,5,7
FwCGymHmbqcziisH5,prop17,14,1,13,15
FwCGymHmbqcziisH5,prop18,2,1,1,1
zRAn69AocpkmxXZnW,inv1,17,8,9,34
zRAn69AocpkmxXZnW,inv2,14,7,7,18
zRAn69AocpkmxXZnW,inv3,50,19,31,74
zRAn69AocpkmxXZnW,inv4,92,16,76,155
zRAn69AocpkmxXZnW,inv5,92,12,80,161
zRAn69AocpkmxXZnW,inv6,70,13,57,124
zRAn69AocpkmxXZnW,inv7,82,18,64,144
zRAn69AocpkmxXZnW,inv8,69,14,55,109
zRAn69AocpkmxXZnW,inv9,132,21,111,214
zRAn69AocpkmxXZnW,inv10,137,13,124,223
zRAn69AocpkmxXZnW,inv11,214,23,191,289
zRAn69AocpkmxXZnW,inv12,114,14,100,155
zRAn69AocpkmxXZnW,inv13,93,22,71,126
zRAn69AocpkmxXZnW,inv14,181,13,168,210
zRAn69AocpkmxXZnW,inv15,155,6,149,230
PSqwzYAfW9dFAa9im,inv1,371,54,317,623
PSqwzYAfW9dFAa9im,inv2,91,41,50,142
PSqwzYAfW9dFAa9im,inv3,201,37,164,340
PSqwzYAfW9dFAa9im,inv4,171,26,145,358
PSqwzYAfW9dFAa9im,inv5,592,127,465,844
PSqwzYAfW9dFAa9im,inv6,308,81,227,436
PSqwzYAfW9dFAa9im,inv7,403,72,331,553
PSqwzYAfW9dFAa9im,inv8,206,51,155,316
PSqwzYAfW9dFAa9im,inv9,644,63,581,885
PSqwzYAfW9dFAa9im,inv10,134,41,93,196
PSqwzYAfW9dFAa9im,inv11,141,56,85,177
PSqwzYAfW9dFAa9im,inv12,240,55,185,385
PSqwzYAfW9dFAa9im,inv13,234,46,188,309
PSqwzYAfW9dFAa9im,inv14,220,54,166,295
PSqwzYAfW9dFAa9im,inv15,183,57,126,211
YH3ANm7Y5Qe5dSYem,inv1,15,5,10,26
YH3ANm7Y5Qe5dSYem,inv2,12,8,4,15
YH3ANm7Y5Qe5dSYem,inv3,48,22,26,79
YH3ANm7Y5Qe5dSYem,inv4,58,15,43,106
YH3ANm7Y5Qe5dSYem,inv5,86,10,76,142
YH3ANm7Y5Qe5dSYem,inv6,28,9,19,52
YH3ANm7Y5Qe5dSYem,inv7,32,12,20,49
YH3ANm7Y5Qe5dSYem,inv8,59,10,49,87
YH3ANm7Y5Qe5dSYem,inv9,63,11,52,96
YH3ANm7Y5Qe5dSYem,inv10,30,4,26,48
YH3ANm7Y5Qe5dSYem,inv11,262,12,250,404
YH3ANm7Y5Qe5dSYem,inv12,188,11,177,295
YH3ANm7Y5Qe5dSYem,inv13,82,5,77,117
YH3ANm7Y5Qe5dSYem,inv14,286,16,270,389
YH3ANm7Y5Qe5dSYem,inv15,124,8,116,168
JDKw8yJZF5fiP3jv3,inv1,151,36,115,244
JDKw8yJZF5fiP3jv3,inv2,56,31,25,82
JDKw8yJZF5fiP3jv3,inv3,103,24,79,155
JDKw8yJZF5fiP3jv3,inv4,76,18,58,124
JDKw8yJZF5fiP3jv3,inv5,346,87,259,447
JDKw8yJZF5fiP3jv3,inv6,194,57,137,265
JDKw8yJZF5fiP3jv3,inv7,210,57,153,280
JDKw8yJZF5fiP3jv3,inv8,110,36,74,171
JDKw8yJZF5fiP3jv3,inv9,347,39,308,465
JDKw8yJZF5fiP3jv3,inv10,122,31,91,179
JDKw8yJZF5fiP3jv3,inv11,90,45,45,110
JDKw8yJZF5fiP3jv3,inv12,110,32,78,170
JDKw8yJZF5fiP3jv3,inv13,77,15,62,97
JDKw8yJZF5fiP3jv3,inv14,99,24,75,131
JDKw8yJZF5fiP3jv3,inv15,22,8,14,23
sDLK7uBCbgZon3znd,inv1,30,12,18,50
sDLK7uBCbgZon3znd,inv2,18,6,12,28
sDLK7uBCbgZon3znd,inv3,12,5,7,19
sDLK7uBCbgZon3znd,inv4,32,13,19,55
sDLK7uBCbgZon3znd,inv5,35,12,23,58
sDLK7uBCbgZon3znd,inv6,69,8,61,121
sDLK7uBCbgZon3znd,inv7,92,15,77,180
sDLK7uBCbgZon3znd,inv8,24,17,7,36
sDLK7uBCbgZon3znd,inv9,52,27,25,71
sDLK7uBCbgZon3znd,inv10,62,12,50,100
JC8Tij8o8GZb99gEJ,Inv1,51,8,43,87
JC8Tij8o8GZb99gEJ,Inv2,85,18,67,98
JC8Tij8o8GZb99gEJ,Inv3,120,7,113,152
JC8Tij8o8GZb99gEJ,Inv4,201,1,200,261
dkZH6HJNQNLLDX6Aj,inv1,364,56,308,696
dkZH6HJNQNLLDX6Aj,inv2,174,50,124,376
dkZH6HJNQNLLDX6Aj,inv3,1189,201,988,1651
dkZH6HJNQNLLDX6Aj,inv4,505,111,394,814
dkZH6HJNQNLLDX6Aj,inv5,492,57,435,1075
dkZH6HJNQNLLDX6Aj,inv6,321,62,259,474
dkZH6HJNQNLLDX6Aj,inv7,1304,63,1241,2011
dkZH6HJNQNLLDX6Aj,inv8,439,126,313,589
zoEADeCW2b2suJB2k,inv1,49,11,38,86
zoEADeCW2b2suJB2k,inv2,35,7,28,51
zoEADeCW2b2suJB2k,inv3,132,9,123,229
zoEADeCW2b2suJB2k,inv4,309,24,285,430
zoEADeCW2b2suJB2k,inv5,149,15,134,201
zoEADeCW2b2suJB2k,inv6,41,18,23,63
zoEADeCW2b2suJB2k,inv7,173,9,164,222
aTwuoJgesSd8hXXEP,inv1,50,21,29,83
aTwuoJgesSd8hXXEP,inv2,175,39,136,244
aTwuoJgesSd8hXXEP,inv3,28,7,21,43
aTwuoJgesSd8hXXEP,inv4,101,30,71,145
aTwuoJgesSd8hXXEP,inv5,108,44,64,131
aTwuoJgesSd8hXXEP,inv6,74,13,61,127
aTwuoJgesSd8hXXEP,inv7,98,23,75,162
aTwuoJgesSd8hXXEP,inv8,81,36,45,105
aTwuoJgesSd8hXXEP,inv9,339,11,328,382
aTwuoJgesSd8hXXEP,inv10,64,8,56,74
9jPK8KBWzjFmBx4Hb,prop1,33,16,17,50
9jPK8KBWzjFmBx4Hb,prop2,60,4,56,134
9jPK8KBWzjFmBx4Hb,prop3,7,2,5,10
9jPK8KBWzjFmBx4Hb,prop4,56,4,52,109
9jPK8KBWzjFmBx4Hb,prop5,180,8,172,305
9jPK8KBWzjFmBx4Hb,prop6,143,13,130,262
9jPK8KBWzjFmBx4Hb,prop7,28,5,23,51
9jPK8KBWzjFmBx4Hb,prop8,134,4,130,240
9jPK8KBWzjFmBx4Hb,prop9,51,6,45,88
9jPK8KBWzjFmBx4Hb,prop10,105,2,103,221
9jPK8KBWzjFmBx4Hb,prop11,93,8,85,143
9jPK8KBWzjFmBx4Hb,prop12,238,6,232,349
9jPK8KBWzjFmBx4Hb,prop13,48,14,34,67
9jPK8KBWzjFmBx4Hb,prop14,84,14,70,116
9jPK8KBWzjFmBx4Hb,prop15,25,2,23,45
9jPK8KBWzjFmBx4Hb,prop16,65,5,60,98
9jPK8KBWzjFmBx4Hb,prop17,97,10,87,120
9jPK8KBWzjFmBx4Hb,prop18,125,4,121,193
9jPK8KBWzjFmBx4Hb,prop19,44,2,42,65
9jPK8KBWzjFmBx4Hb,prop20,42,4,38,75
WGdhwKZnCu7aKhXq9,Inv1,14,6,8,18
WGdhwKZnCu7aKhXq9,Inv2,32,9,23,34
WGdhwKZnCu7aKhXq9,Inv3,45,6,39,51
WGdhwKZnCu7aKhXq9,Inv4,94,8,86,125
gAeD3MTGCCv8YNTaK,undirected,150,29,121,242
gAeD3MTGCCv8YNTaK,oriented,94,24,70,150
gAeD3MTGCCv8YNTaK,acyclic,78,15,63,126
gAeD3MTGCCv8YNTaK,complete,104,18,86,191
gAeD3MTGCCv8YNTaK,noLoops,59,15,44,106
gAeD3MTGCCv8YNTaK,weaklyConnected,251,16,235,411
gAeD3MTGCCv8YNTaK,stonglyConnected,77,16,61,128
gAeD3MTGCCv8YNTaK,transitive,58,16,42,82
